TILEMAP
16 32				-- Size of tile map in tiles
26 26				-- Tile size & block size
images/sprite-sheet.png		-- Tilesheet
12 27				-- Number of tiles in tilesheet   
0000000000000000
0000000000000000
1111111111111111
2222222222222222
1000000000000001
2000000000000002
1000000000000001
2000000000000002
1003444004443001
2030000440000302
1033333003333301
2055555445555502
1050000000000501
2055555445555502
1066666006666601
2060000440000602
1006444004446001
2000000000000002
1000000000000001
2000000000000002
1000000000000001
2000000000000002
1000000000000001
2000000000000002
1033000000003301
2050000000000502
1066000000006601
2000000000000002
1000000000000001
2000000000000002
1111000000001111
2222000000002222